Lebel 3
64 48
################################################################
#                                                              #
#                                                              #
#                                                              #
#                                                              #
#                                                              #
#                                                              #
#                                                              #
#             #                                    #           #
#             #                                    #           #
#             #                                    #           #
#             #                                    #           #
#             #                                    #           #
#             #                                    #           #
#             #                                    #           #
#             #                                    #           #
#             #                                    #           #
#             #                                    #           #
#             #                                    #           #
#             #                                    #           #
#             #                                    #           #
#             #                                    #           #
#             #                                    #           #
#             #                                    #           #
#             #                                    #           #
#             #                                    #           #
#             #                                    #           #
#             #                                    #           #
#             #                                    #           #
#             #                                    #           #
#             #                                    #           #
#             #                                    #           #
#             #                                    #           #
#             #                                    #           #
#             #                                    #           #
#             #                                    #           #
#             #                                    #           #
#             #                                    #           #
#             #                                    #           #
#             #                                    #           #
#                                                              #
#                                                              #
#                                                              #
#                                                              #
#                                                              #
#                                                              #
#                                                              #
################################################################
