Level 4
64 48
################################################################
#                  #                                           #
#                  #                                           #
#                  #                                           #
#                  #                                           #
#                  #                                           #
#                  #                                           #
#                  #                                           #
#                  #                                           #
#                  #                                           #
#                  #                                           #
#                  #                                           #
#                  #                                           #
#                  #                                           #
#                  #                                           #
#                  #             ###############################
#                  #                                           #
#                  #                                           #
#                  #                                           #
#                  #                                           #
#                  #                                           #
#                  #                                           #
#                  #                                           #
#                  #                                           #
#                                          #                   #
#                                          #                   #
#                                          #                   #
#                                          #                   #
#                                          #                   #
#                                          #                   #
#                                          #                   #
################################           #                   #
#                                          #                   #
#                                          #                   #
#                                          #                   #
#                                          #                   #
#                                          #                   #
#                                          #                   #
#                                          #                   #
#                                          #                   #
#                                          #                   #
#                                          #                   #
#                                          #                   #
#                                          #                   #
#                                          #                   #
#                                          #                   #
#                                          #                   #
################################################################
