Level 5
64 48
################################################################
#                                                              #
#                                                              #
#                                                              #
#                                                              #
#                                                              #
#                                                              #
#                                                              #
#             ####################################             #
#                                                              #
#           #                                      #           #
#           #                                      #           #
#           #                                      #           #
#           #                                      #           #
#           #                                      #           #
#           #                                      #           #
#           #                                      #           #
#           #                                      #           #
#           #                                      #           #
#           #                                      #           #
#           #                                      #           #
#           #                                      #           #
#           #                                      #           #
#           #                                      #           #
#           #                                      #           #
#           #                                      #           #
#           #                                      #           #
#           #                                      #           #
#           #                                      #           #
#           #                                      #           #
#           #                                      #           #
#           #                                      #           #
#           #                                      #           #
#           #                                      #           #
#           #                                      #           #
#           #                                      #           #
#           #                                      #           #
#                                                              #
#             ####################################             #
#                                                              #
#                                                              #
#                                                              #
#                                                              #
#                                                              #
#                                                              #
#                                                              #
#                                                              #
################################################################
