Levl 6
64 48
################################################################
#      #      #      #      #      #      #      #      #      #
#      #      #      #      #      #      #      #      #      #
#      #      #      #      #      #      #      #      #      #
#      #      #      #      #      #      #      #      #      #
#      #      #      #      #      #      #      #      #      #
#      #      #      #      #      #      #      #      #      #
#      #      #      #      #      #      #      #      #      #
#      #      #      #      #      #      #      #      #      #
#      #      #      #      #      #      #      #      #      #
#      #      #      #      #      #      #      #      #      #
#      #      #      #      #      #      #      #      #      #
#      #      #      #      #      #      #      #      #      #
#      #      #      #      #      #      #      #      #      #
#      #      #      #      #      #      #      #      #      #
#      #      #      #      #      #      #      #      #      #
#      #      #      #      #      #      #      #      #      #
#      #      #      #      #      #      #      #      #      #
#      #      #      #      #      #      #      #      #      #
#      #      #      #      #      #      #      #      #      #
#      #      #      #      #      #      #      #      #      #
#                                                              #
#                                                              #
#                                                              #
#                                                              #
#                                                              #
#                                                              #
#                                                              #
#                                                              #
#                                                              #
#                                                              #
#                                                              #
#      #      #      #      #      #      #      #      #      #
#      #      #      #      #      #      #      #      #      #
#      #      #      #      #      #      #      #      #      #
#      #      #      #      #      #      #      #      #      #
#      #      #      #      #      #      #      #      #      #
#      #      #      #      #      #      #      #      #      #
#      #      #      #      #      #      #      #      #      #
#      #      #      #      #      #      #      #      #      #
#      #      #      #      #      #      #      #      #      #
#      #      #      #      #      #      #      #      #      #
#      #      #      #      #      #      #      #      #      #
#      #      #      #      #      #      #      #      #      #
#      #      #      #      #      #      #      #      #      #
#      #      #      #      #      #      #      #      #      #
#      #      #      #      #      #      #      #      #      #
################################################################
