Level 7
64 48
################################################################
#                                                              #
#                              #                               #
#                                                              #
#                              #                               #
#                                                              #
#                              #                               #
#                                                              #
#                              #                               #
#                                                              #
#                              #                               #
#                                                              #
#                              #                               #
#                                                              #
#                              #                               #
#                                                              #
#                              #                               #
#                                                              #
#                              #                               #
#                                                              #
#                              #                               #
#                                                              #
#                              #                               #
#                                                              #
#                              #                               #
#                                                              #
#                              #                               #
#                                                              #
#                              #                               #
#                                                              #
#                              #                               #
#                                                              #
#                              #                               #
#                                                              #
#                              #                               #
#                                                              #
#                              #                               #
#                                                              #
#                              #                               #
#                                                              #
#                              #                               #
#                                                              #
#                              #                               #
#                                                              #
#                              #                               #
#                                                              #
#                              #                               #
################################################################
