Level 8
64 48
################################################################
#        #                     #                     #         #
#        #                     #                     #         #
#        #                     #                     #         #
#        #                     #                     #         #
#        #                     #                     #         #
#        #                     #                     #         #
#        #                     #                     #         #
#        #                     #                     #         #
#        #                     #                     #         #
#        #                     #                     #         #
#        #                     #                     #         #
#        #                     #                     #         #
#        #                     #                     #         #
#        #                     #                     #         #
#        #          #          #          #          #         #
#        #          #          #          #          #         #
#        #          #          #          #          #         #
#        #          #          #          #          #         #
#        #          #          #          #          #         #
#        #          #          #          #          #         #
#        #          #          #          #          #         #
#        #          #          #          #          #         #
#        #          #          #          #          #         #
#        #          #          #          #          #         #
#        #          #          #          #          #         #
#        #          #          #          #          #         #
#        #          #          #          #          #         #
#        #          #          #          #          #         #
#        #          #          #          #          #         #
#        #          #          #          #          #         #
#        #          #          #          #          #         #
#        #          #          #          #          #         #
#                   #                     #                    #
#                   #                     #                    #
#                   #                     #                    #
#                   #                     #                    #
#                   #                     #                    #
#                   #                     #                    #
#                   #                     #                    #
#                   #                     #                    #
#                   #                     #                    #
#                   #                     #                    #
#                   #                     #                    #
#                   #                     #                    #
#                   #                     #                    #
#                   #                     #                    #
################################################################
