Level 9
64 48
################################################################
#               #               #               #              #
#       #               #               #               #      #
#               #               #               #              #
#       #               #               #               #      #
#               #               #               #              #
#       #               #               #               #      #
#               #               #               #              #
#       #               #               #               #      #
#               #               #               #              #
#       #               #               #               #      #
#               #               #               #              #
#       #               #               #               #      #
#               #               #               #              #
#       #               #               #               #      #
#               #               #               #              #
#       #               #               #               #      #
#               #               #               #              #
#       #               #               #               #      #
#               #               #               #              #
#       #               #               #               #      #
#               #               #               #              #
#       #               #               #               #      #
#               #               #               #              #
#       #               #               #               #      #
#               #               #               #              #
#       #               #               #               #      #
#               #               #               #              #
#       #               #               #               #      #
#               #               #               #              #
#       #               #               #               #      #
#               #               #               #              #
#       #               #               #               #      #
#               #               #               #              #
#       #               #               #               #      #
#               #               #               #              #
#       #               #               #               #      #
#               #               #               #              #
#       #               #               #               #      #
#               #               #               #              #
#       #               #               #               #      #
#               #               #               #              #
#       #               #               #               #      #
#               #               #               #              #
#       #               #               #               #      #
#               #               #               #              #
#       #               #               #               #      #
################################################################
